equality relationship	同等関係性	とりあえず
protocol composition	プロトコル合成
designated initializer	指定イニシャライザ
context-sensitive	文脈依存	とりあえず
subclassed	サブクラスを作られる	サブクラスにされる？
open access	開放アクセス	とりあえず
file-private access	ファイル内用アクセス	とりあえず。ファイル内限定アクセス、ファイル非公開アクセス
file-private access	ファイル限定アクセス
file-private access	ファイル外非公開
abstract type	抽象型
inlinable	インライン可能	とりあえず
box-drawing character	罫線文字	Box-drawing characters, also known as line-drawing characters, ...、罫線素片、line-drawing character 書式印刷文字
number sign	シャープ記号	番号記号
projected value	投影値	とりあえず、データベース用語の射影（または投影）のようなもの？特定の列データを取り出す。元は以下にしていた、予測値、見込値
API contract	API契約	とりあえず、APIコントラクト
fallback	フォールバック	縮退運転、機能を制限して動作させる。
failback	フェイルバック	切り戻し、予備から主に戻す。
availability	有効性	availability condition = 有効性条件
concurrency	並行性
parallel	並列
asynchronous	非同期
be used to	慣れている	get used to 慣れる
